    111111
    100001
    100001
111110000111111
100000000000001
100000N00000001
100000000000001
111110000111111
    100001
    100001
    111111
