  1111111   11111111111111111
110000000111000000100001
101100000110000000000001
100100000000000000000001
111111111110000000000001
100000000000000000000001
10000000000N000000000001
100000000000000000000001
100000000000000000000001
100000000000100000000001
110000000111000000100001
  1111111   11111111111
